 * * # * *
* # * * * 
 * # # # *
* # * * *
 * # # # *